10000000000000001
10000000000000001
10000000000000001
10000000000000001
10000000000000001
10000000000000001
10000000000000001
10000000000000001
10000000000000001
10000000000000001
10000000000000001
10000000000000001
10000000000000001
10000000000000001
10000000000000001
10000000000000001
10000000000000001
10000000000000001
10000000000000001
10000000000000001
10000000000000001
10000000000000001
19009990009909001
10099990090099091
19009900990900091
11111111111111111